10 10
OOOOOXOOOO
XOOOOOOOOX
OOXXOOOXOO
OOOOOOOOXO
OXOOOOOXOO
OOOXOOOOXO
XOOOOOOOOX
OOOOOOXOOO
OXOOOOOXXO
OOOOXOOOOO